50
50
############################################################################
               #        #        #     #        #                 #        #
#############  #  ####  #  ####  ####  #  #  #  ##########  ####  #  ####  #
#           #  #     #  #     #     #  #  #  #           #  #     #  #  #  #
#  #######  #  #  #  #  ####  ####  #  #  #############  #  #######  #  #  #
#        #     #  #  #  #     #  #     #  #           #  #           #  #  #
####  #  ##########  #  #  ####  #  ####  #  #######  #  ####  #######  #  #
#     #  #        #  #     #  #     #     #  #     #  #     #  #     #     #
#  ####  #  ####  #  ####  #  #######  ####  ####  #  ####  #  #  ####  ####
#     #  #     #  #     #     #     #  #  #     #  #        #  #        #  #
####  #######  #  ####  #######  #  #  #  ####  #  ##########  ##########  #
#              #     #        #  #     #  #  #     #     #     #     #     #
#  #######  #  ####  #######  #  #######  #  ##########  #  ####  #  #  #  #
#        #  #     #           #        #        #                 #  #  #  #
#######  #  ####  #######  ##########  #  ####  #  #######  #######  #  #  #
#     #  #  #  #        #                 #  #  #     #     #     #     #  #
#  #  #  #  #  #######  #############  ####  #  ####  #  ####  #  #######  #
#  #     #     #        #  #           #     #        #        #  #        #
#  #############  #######  #  ##########  ######################  #  #######
#  #           #  #     #     #                                   #  #     #
#  #######  ####  #  #  #######  #############  ###################  ####  #
#        #        #  #  #        #              #  #        #        #     #
####  ################  ####  ##########  #######  #  ####  #  #  ####  ####
#  #     #                 #        #     #        #     #     #        #  #
#  #  #  #  #############  #######  #######  #######  #  ################  #
#  #  #     #              #        #        #        #  #        #        #
#  #  #######  #############  ####  #  ##########  ####  #  ####  #  ####  #
#  #     #  #        #  #     #     #                 #  #  #  #  #     #  #
#  #  #  #  ####  #  #  #  ####  #############  #  ####  #  #  #  ####  ####
#  #  #  #     #  #  #     #     #     #     #  #  #        #  #     #     #
#  #  #  ####  ####  #######  #######  #  #  ####  #  #######  ####  ####  #
#  #  #  #     #     #     #  #           #        #     #  #        #  #  #
#  ####  #  ####  #######  #  #######  ################  #  ##########  #  #
#     #  #     #     #     #     #     #     #     #     #        #        #
#  #  #  ####  #  ####  #  ####  ##########  #  #  #  ##########  #  #######
#  #        #  #        #  #     #     #     #  #     #              #     #
##########  #  ##########  #######  #  #  ####  #######  #######  ####  ####
#           #  #        #        #  #  #              #  #     #     #     #
#  #######  #  #  ####  #######  #  #  ##########  #  #  #  #  ####  #  #  #
#        #  #  #  #  #  #     #  #  #              #  #     #  #  #     #  #
#######  ####  #  #  #  #  #  #  #  ##########  #############  #  #######  #
#     #        #  #  #     #     #           #        #        #     #     #
#  #############  #  ######################  #######  #  ##########  #  ####
#  #     #  #     #                 #  #     #                    #     #  #
#  #  #  #  #  ####  #############  #  #  ##########  #######  #  #######  #
#  #  #     #     #  #           #  #  #  #           #        #     #     #
#  #  ##########  ####  #  ####  #  #  #  #  ##########  ##########  #  #  #
#  #        #           #  #     #  #     #        #  #  #           #  #  #
#  #  #  #  #############  #  #  #  #############  #  #  #  #######  #  #  #
#     #  #                 #  #     #              #     #        #     #   
############################################################################
