50
50
############################################################################
   #           #     #     #              #  #     #        #              #
#  #  #######  #  #  #  #  #  #######  #  #  #  #  ####  #  #  #######  ####
#     #     #     #     #  #  #     #  #     #  #  #     #  #  #     #     #
#######  #  ##########  #  ####  #  #  #######  #  #  ####  #  #  #  ####  #
#        #        #     #        #     #        #  #  #     #     #  #     #
#  ####  #######  ##########  ####  ####  #######  #  #  #############  #  #
#  #  #  #        #        #  #     #           #  #  #                 #  #
#  #  #  ##########  ####  ####  #  #  #######  #  #  #############  ####  #
#  #  #        #     #           #  #        #  #  #              #  #     #
#  #  ####  #  #  ####  #  #######  #######  #  #  ####  #######  #  #######
#  #     #  #     #     #     #     #        #  #  #     #        #     #  #
#  #  #  ##########  #######  #  ####  #######  #  #  ####  ##########  #  #
#  #  #     #        #     #  #        #        #  #     #  #     #  #     #
#  #  ####  #  #######  #  #  ##########  #######  ####  #  #  #  #  ####  #
#     #     #  #        #  #     #     #  #     #        #     #  #        #
#######  ####  #  #######  ####  #  #  #  #  ###################  #  #######
#     #  #     #     #  #        #  #     #  #                    #     #  #
#  ####  #  #######  #  ####  #############  #  ##########  ##########  #  #
#        #     #  #  #     #              #     #           #        #     #
#############  #  #  ####  #############  #######  ##########  ####  ####  #
#              #  #     #                    #  #  #  #     #  #  #        #
#  #############  ####  #############  ####  #  #  #  #  #  #  #  ##########
#        #     #     #  #           #  #        #     #  #     #        #  #
#######  #  #  ####  #  #  #######  #  #  #############  ##########  #  #  #
#        #  #     #  #  #     #     #  #  #  #        #  #     #     #     #
#  #############  #  #  ####  #######  #  #  #  ####  #  #  #  #  ##########
#     #           #     #  #     #  #  #     #  #     #  #  #  #  #        #
####  #  #######  #######  ####  #  #  ####  ####  ####  #  #  #  #  ####  #
#  #  #  #     #  #  #     #  #        #  #        #        #     #  #     #
#  #  #  #  #  #  #  #  #  #  #  #  ####  #########################  #######
#  #     #  #     #     #     #  #        #                       #        #
#  #######  #######  #  #######  ####  ####  ###################  #######  #
#  #     #  #     #  #     #     #     #     #           #                 #
#  #  #  #  #  #  #  #######  ####  ##########  ####  #  ##########  #######
#     #     #  #  #        #  #  #  #     #     #  #  #  #        #  #     #
####  #######  #  #######  #  #  #  #  #  #  ####  #  #  #  ####  #  #  #  #
#     #        #        #        #     #  #        #  #        #     #  #  #
#  ####  ##########  #  ################  ##########  ###################  #
#  #  #     #     #  #                 #  #        #  #        #        #  #
#  #  ####  ####  #  ################  #  #  ####  #  #  ####  #  ####  #  #
#     #     #     #  #     #        #  #  #  #     #     #  #     #     #  #
##########  #  ####  #  #  #  ####  #  #  #  #  ####  ####  #  ####  ####  #
#     #     #        #  #        #  #        #     #  #     #  #     #     #
#  #  #  #############  ####  ####  ####  #  #  #  #  #  ####  #  #######  #
#  #  #        #     #     #     #        #  #  #     #        #        #  #
#  #  #######  #  #  ##########  #############  #  #  #############  #  #  #
#  #  #        #  #  #           #        #     #  #  #     #     #  #     #
#  ####  ##########  #  ##########  #  #  #  ####  #  #  #  ####  #  #######
#        #              #           #  #     #     #     #        #         
############################################################################
