50
50
############################################################################
      #                 #        #              #     #                 #  #
#  #  #  #############  #  ####  #  ####  ####  #  #  #  #######  ####  #  #
#  #     #  #           #  #     #     #  #  #  #  #  #  #     #     #  #  #
#  #######  #  ##########  #  #######  #  #  #  ####  #  #  #  #  ####  #  #
#  #        #  #     #     #  #        #  #     #     #  #  #     #     #  #
#  #  #######  #  #  #  ####  ##########  #######  ####  ##########  ####  #
#     #        #  #  #     #     #     #        #     #  #     #        #  #
#######  #  #######  ##########  #  #  #######  ####  #  #  #  #  #######  #
#     #  #     #     #           #  #     #        #  #     #  #        #  #
#  #  #######  #  ####  ##########  ####  #  ####  #  #######  ####  #  #  #
#  #              #                 #     #     #              #     #  #  #
#  ##########  ####  #########################  ####  ################  #  #
#  #        #                       #     #  #     #     #              #  #
#  #  ####  ###################  ####  #  #  ####  ####  #  #############  #
#  #     #  #        #        #     #  #  #        #     #  #              #
#  ####  #  #  ####  #  ####  ####  ####  ##########  ####  #  #######  ####
#  #     #  #     #  #  #     #           #           #     #  #           #
#  #######  #######  #  #  ####  #  #######  ##########  ####  #  ##########
#     #  #  #     #  #  #     #  #  #     #  #     #  #        #  #        #
####  #  #  #  #  #  #  #######  #  #  #  #  ####  #  ##########  #  ####  #
#  #        #  #     #           #  #  #  #     #  #        #  #  #     #  #
#  ####  ####  ###################  #  #  ####  #  #######  #  #  #######  #
#  #  #  #  #     #        #        #  #           #        #     #        #
#  #  #  #  ####  #  ####  #  #######  #######  ####  #######  ####  ####  #
#  #     #  #  #  #     #     #        #        #           #     #  #     #
#  #######  #  #  #######  #######  #  #############  ####  ####  #  #  #  #
#        #        #        #     #  #  #     #     #     #     #     #  #  #
#######  #######  #  #######  #  #  ####  #  #  #  ####  ####  #  ####  ####
#     #     #     #        #  #  #        #  #  #  #     #     #  #  #     #
#  #######  #  ####  #######  #  #  #######  #  #  #######  ####  #  ####  #
#  #        #                 #     #        #  #     #     #  #  #        #
#  #  #  ##########  ################  #######  ####  #  ####  #  ##########
#  #  #  #           #        #     #  #        #  #  #     #     #        #
#  #  #  #  ####  ##########  #  ####  #  #  ####  #  ####  #  ####  #  #  #
#     #     #     #                    #  #  #     #  #     #     #  #  #  #
#############  ####  ###################  ####  ####  #  ####  #  #  #  ####
#           #  #  #     #              #        #  #  #        #     #     #
#  ##########  #  ####  #  ####  ####  #######  #  #  ###################  #
#  #           #        #  #     #     #     #  #  #     #                 #
#  #  ################  #  #  ####  ####  ####  #  #  ####  ####  ##########
#  #  #           #     #  #  #  #     #        #  #     #  #     #        #
#  #  #  #######  #  #######  #  ####  ##########  ####  #  #  ##########  #
#     #     #     #           #        #        #     #     #              #
####  ####  #  ################  #############  ####  #  ###################
#  #        #  #           #     #        #           #  #                 #
#  ##########  #  #######  #############  ####  #  #######  #############  #
#  #           #  #     #  #           #     #  #  #     #           #  #  #
#  #  #  #######  #  #  #  #  #######  #  #  #  #  #  #  ##########  #  #  #
#     #           #  #        #           #     #     #              #      
############################################################################
